#########################
#.............B...-..H..#
#.2.&.............-..1..#
#...D.........A...-.....#
#########################

?1/
?2/
?D|
?A_
?B_
?H!

=2A
=2B
=1D
@D14
@A (0,1)
@B (0,-1)
@2T
@H13a