#####################
#...-...+...-...+...#
#...-.H.+...-...+...#
#.&.-...+...-...+.D.#
#####################

?D|
?H!

@D15
@H14a