.... #####
..###..~..###
.#.....~.....#.
#1.....~...*..#
#......~..H...#
#......~......#
#......~......#
#.&....~....D.#
###############

?1/
?D|
?H!

=1D
@1T
@D09
@H08a